11111111111
11110C01111
11110001111
11110X01111
11110001111
10000000001
1C0X0P0X0E1
10000000001
11110X01111
11110001111
11110001111
11111111111
