111111
1P00C1
10E001
100111
1C01C1
111111