1111111111111111111111111111111111
1E0000000000X00C00000C000X00000001
1110010100100000101001000000010101
1110010010101010001001000000010101
1P0000000C00C00000X0000000X00000C1
1111111111111111111111111111111111
