1111111111111
100100000X0C1
1000011111001
1P0011E00X001
1111111111111
